{
    "r0": 25,
    "r1": 28,
    "r2": 25,
    "r3": 21,
    "r4": 22,
    "r5": 27,
    "r6": 26,
    "r7": 22,
    "r8": 30,
    "r9": 24,
    "r10": 20,
    "r11": 20,
    "r12": 24,
    "r13": 20,
    "r14": 24,
    "r15": 21,
    "r16": 20,
    "r17": 21,
    "r18": 20,
    "r19": 20,
    "r20": 25,
    "r21": 28,
    "r22": 30,
    "r23": 26,
    "r24": 24,
    "r25": 20,
    "r26": 27,
    "r27": 25,
    "r28": 20,
    "r29": 21,
    "r30": 24,
    "r31": 28,
    "r32": 27,
    "r33": 30,
    "r34": 26,
    "r35": 20,
    "r36": 25,
    "r37": 20,
    "r38": 21,
    "r39": 28,
    "r40": 25,
    "r41": 24,
    "r42": 26,
    "r43": 25,
    "r44": 30,
    "r45": 24,
    "r46": 24,
    "r47": 21,
    "r48": 30,
    "r49": 25,
    "r50": 30,
    "r51": 24,
    "r52": 20,
    "r53": 28,
    "r54": 22,
    "r55": 30,
    "r56": 24,
    "r57": 25,
    "r58": 27
}