{
    "r0": 32,
    "r1": 34,
    "r2": 30,
    "r3": 33,
    "r4": 34,
    "r5": 33,
    "r6": 34,
    "r7": 31,
    "r8": 31,
    "r9": 34,
    "r10": 32,
    "r11": 30,
    "r12": 35,
    "r13": 30,
    "r14": 30,
    "r15": 35,
    "r16": 32,
    "r17": 33,
    "r18": 30,
    "r19": 31,
    "r20": 34,
    "r21": 34,
    "r22": 34,
    "r23": 34,
    "r24": 33,
    "r25": 32,
    "r26": 33,
    "r27": 35,
    "r28": 33,
    "r29": 35,
    "r30": 34,
    "r31": 33,
    "r32": 32,
    "r33": 32,
    "r34": 30,
    "r35": 33,
    "r36": 33,
    "r37": 30,
    "r38": 31,
    "r39": 35,
    "r40": 33,
    "r41": 35,
    "r42": 30,
    "r43": 30,
    "r44": 33,
    "r45": 35,
    "r46": 33,
    "r47": 34,
    "r48": 33,
    "r49": 35,
    "r50": 33,
    "r51": 30,
    "r52": 31,
    "r53": 33,
    "r54": 31,
    "r55": 34,
    "r56": 34,
    "r57": 31,
    "r58": 33
}